; Legend
; # wall (blocking)
; . floor (walkable)
; D door (blocking for now)

######################
#........#...........#
#........#....####...#
#..####..#....#..#...#
#..#..#..####.#..#...#
#..#..#.......#..#...#
#..####.#####.#..#...#
#.......#...#.#..#...#
#.#####.#.D.#.####...#
#.#...#.#...#........#
#.#...#.#####.####...#
#.#####..............#
######################
